0,0,0,0,0,0,0,0,0,0
0,10,10,10,0,0,10,10,10,0
0,10,1,0,0,0,0,3,10,0
0,10,0,0,0,0,0,0,10,0
0,0,0,0,11,11,0,0,0,0
0,0,0,0,11,11,0,0,0,0
0,10,0,0,0,0,0,0,10,0
0,10,3,0,0,0,0,1,10,0
0,10,10,10,0,0,10,10,10,0
0,0,0,0,0,0,0,0,0,0
