0,0,0,0,0,0,0,0,0,0,0,0,0,0,0
0,0,0,0,0,0,0,0,0,0,0,0,0,0,0
0,0,0,0,0,0,0,0,0,0,0,0,0,0,0
0,0,0,0,0,0,0,0,0,0,0,0,0,0,0
0,0,0,0,0,0,0,13,13,13,13,13,0,0,0
0,0,0,0,0,0,0,13,0,0,0,13,0,0,0
0,0,0,14,0,16,0,4,0,15,0,13,0,0,0
9,9,9,9,9,9,9,9,9,9,9,13,9,9,9
