10,10,10,10,10,10,10,10,10,10
10,0,0,0,0,0,0,0,0,10
10,0,0,0,0,0,0,0,0,10
10,0,0,0,0,0,0,0,0,10
10,0,0,0,0,0,0,0,0,10
10,0,0,0,0,0,0,0,0,10
10,0,14,0,0,0,0,15,0,10
10,10,10,10,10,10,10,10,10,10
