0,0,0,0,0,0,0,0,0,0
0,10,10,10,10,10,10,10,10,0
0,10,1,0,0,0,0,3,10,0
0,10,0,0,0,0,0,0,10,0
0,10,0,0,12,12,0,0,10,0
0,10,0,0,12,12,0,0,10,0
0,10,0,0,0,0,0,0,10,0
0,10,3,14,0,0,0,1,10,0
0,10,10,10,10,10,10,10,10,0
0,0,0,0,0,0,0,0,0,0
