0,0,0,0,0,0,0,0,0,0,0,0,0,0,0
0,0,0,0,0,0,0,0,0,0,0,0,0,0,0
0,0,0,0,0,0,0,0,0,0,0,0,0,0,0
0,0,0,0,0,0,0,0,0,0,0,0,0,0,0
0,0,0,0,15,0,0,0,0,15,0,0,0,0,0
0,0,0,0,10,0,0,0,0,10,0,0,0,0,0
0,14,0,10,10,10,0,0,10,10,10,0,15,0,0
9,9,9,9,9,9,9,9,9,9,9,9,9,9,9
