0,0,0,0,0,0,0,0,0,0,0,0,0,0,0
0,0,0,0,0,0,0,0,0,0,0,0,0,0,0
0,0,0,0,0,0,0,0,0,0,0,0,0,0,0
0,0,0,0,0,0,0,0,13,13,13,0,0,0,0
0,0,0,0,0,0,0,0,13,0,13,0,0,0,0
0,0,0,0,0,0,0,0,17,15,13,0,0,0,0
0,0,16,0,0,14,0,10,10,10,13,0,0,0,0
9,9,9,9,9,9,9,9,9,9,13,9,9,9,9
