13,13,13,13,13,13,13,13,13,13
13,0,0,0,0,0,0,0,0,13
13,0,0,0,0,0,0,0,0,13
13,0,0,0,0,0,0,0,0,13
13,0,0,0,0,0,0,0,0,13
13,0,0,0,0,0,0,0,0,13
13,0,0,0,0,0,0,0,0,13
13,0,0,0,0,0,0,0,0,13
13,0,14,0,0,0,0,0,0,13
13,9,9,9,9,9,9,9,9,13
