0,0,0,0,0,0,0,0,0,0
0,0,0,0,0,0,0,0,0,0
0,0,0,0,0,0,0,0,0,0
0,0,0,0,0,0,0,0,0,0
0,0,0,0,0,0,0,0,0,0
0,0,0,0,0,0,0,0,0,0
0,0,0,0,0,0,0,10,10,10
0,0,0,0,0,0,0,10,0,0
0,16,0,0,14,0,0,17,0,15
9,9,9,9,9,9,9,9,9,9
