0,0,0,0,0,0,0,0,0,0
0,0,0,0,0,0,0,0,0,0
0,0,0,0,0,0,0,0,0,0
0,0,0,0,0,0,0,0,0,0
0,0,0,0,0,0,0,0,0,0
0,0,0,9,9,0,0,10,10,0
0,0,0,7,7,0,6,6,6,6
9,9,9,7,7,9,9,9,9,9
7,7,7,7,7,7,7,7,7,7
13,13,13,13,13,13,13,13,13,13
