13,10,10,13,13,13,13,10,10,13
13,10,10,13,13,13,13,10,10,13
13,10,0,0,0,0,0,0,10,13
13,0,0,0,11,11,0,0,0,13
13,0,0,0,11,11,0,0,0,13
13,0,0,0,0,0,0,0,0,13
13,10,0,14,0,0,0,0,10,13
13,11,11,11,11,11,11,11,10,13
