13,13,13,13,13,13,13,13,13,13
13,10,10,13,13,13,13,10,10,13
13,10,1,0,0,0,0,3,10,13
13,10,0,0,0,0,0,0,10,13
13,0,0,0,11,11,0,0,0,13
13,0,0,0,11,11,0,0,0,13
13,10,0,0,0,0,0,0,10,13
13,10,3,14,0,0,0,1,10,13
13,10,10,10,13,13,10,10,10,13
13,13,13,13,13,13,13,13,13,13
